The real Crystal City; well, is there such a thing? It's just something you read about in a children's book -- a real city couldn't cure and prevent illness in those who lived there, or keep its glass towers maintained with no one working on them. Even if there is something here, it's just an ordinary city -- nothing to justify your ever-increasing obsession. Nothing to justify coming so far from your home just to look for it.

Still, that's what you've done so far.

Wetlands
An Interactive Quagmire by Clara Raubertas
Release 1 / Serial number 140126 / Inform 7 build 6G60 (I6/v6.32 lib 6/12N) SD
First time players type HELP for more instructions.

Outside Waterworks
You are standing on a paved path leading uphill to the south and downhill to the north.

To the east is a broad brick building on which a lighted archway frames a closed door; a water fountain stands to one side in the archway. 

To the west you can see what looks like a pond, with a small structure rising from the water to the northwest, although a chain-link fence is blocking you from going right up to the pond. 

The ground dips a little on this side of the fence, exposing a large rusty pipe.

>climb fence
You manage to pull yourself up to the top of the fence and drop down on the other side, without causing yourself too much damage.

Muddy Beach
The pond laps gently up to the pile of brush and sticks accumulated here on the muddy shore. You can see some kind of structure rising out of the pond to the north -- it looks like a small boat-house or spring-house.

Behind you to the east you can climb the fence back to where you came from, and to the northeast the shoreline continues.

You can see a beer bottle (empty) here.

[Your score has just gone up by five points.]

>ne
Rocky Beach
A small strip of shoreline, littered with small disclike rocks; sunlight strikes the rippling pond. You can see the structure to the west more clearly now -- it looks like a small boat-house or spring-house -- and it's probably close enough to wade. 

A wooden drawer is half-buried in the beach.

The shoreline continues to the southwest and to the northeast, and behind you to the south and east is a chain-link fence.

A gull swoops down and pecks at the drawer.

>x shoreline
A bunch of small, flat, disclike rocks, worn smooth by the water.

>sw
Muddy Beach
The pond laps gently up to the pile of brush and sticks accumulated here on the muddy shore.  Rising out of the pond to the north, you can see some kind of structure -- it looks like a small boat-house or spring-house.

Behind you to the east you can climb the fence back to where you came from, and to the northeast the shoreline continues.

You can see a beer bottle (empty) here.

You hear a distant train whistle.

>x shoreline
That noun did not make sense in this context.

I beg your pardon?

>w
You peer into the pond and think about it, but something about the murky depths suggests you're better off on land.

A murmuration of starlings flies by you.

>ne
Rocky Beach
A small strip of shoreline, littered with small disclike rocks; sunlight strikes the rippling pond. A wooden drawer is half-buried in the beach. The small structure is visible at the edge of the water to the west.

The shoreline continues to the southwest and to the northeast, and behind you to the south and east is a chain-link fence.

A gull swoops down and pecks at the drawer.

>x rocks
A bunch of small, flat, disclike rocks, worn smooth by the water.

>take rocks
(one of the small rocks)
Taken.

A skein of geese passes overhead.

>take rocks
(the small rock off)
You're not wearing that.

The gull tires of the drawer and flaps up and away.

* * *

>ne
Rocky Beach
A small strip of shoreline, littered with small disclike rocks; sunlight strikes the rippling pond. You can see the structure to the west more clearly now -- it looks like a small boat-house or spring-house -- and it's probably close enough to wade. 

A wooden drawer is half-buried in the beach.

The shoreline continues to the southwest and to the northeast, and behind you to the south and east is a chain-link fence.

A gull swoops down and pecks at the drawer.

>take rock
(picking up one of the small rocks)
Taken.

>i
You are holding a small rock and a page torn out of a children's book.

You are wearing your tall rubber boots, your coat and a watch.

Both the pockets of your coat are empty.

You hear a distant train whistle.

>l
Rocky Beach
A small strip of shoreline, littered with small disclike rocks; sunlight strikes the rippling pond. A wooden drawer is half-buried in the beach. The small structure is visible at the edge of the water to the west.

The shoreline continues to the southwest and to the northeast, and behind you to the south and east is a chain-link fence.

>take rock
(the bunch of rocks)
(picking up another of the small rocks)
Taken.

A gull swoops down and pecks at the drawer.

>small rock
I didn't understand that sentence.

>take rock
(the bunch of rocks)
(picking up another of the small rocks)
(putting the page torn out of a children's book into nothing to make room)
Taken.

>take small rock
(the small rock)
You already have that.

>i
You are holding three small rocks.

You are wearing your tall rubber boots, your coat and a watch.

The left pocket of your coat is empty, and in the right pocket is a page torn out of a children's book.

The gull tires of the drawer and flaps up and away.

Leaves waft intermittently to the ground.

>take small rock
(the small rock)
You already have that.

>i
You are holding three small rocks.

You are wearing your tall rubber boots, your coat and a watch.

The left pocket of your coat is empty, and in the right pocket is a page torn out of a children's book.

* * *

>take rock
(picking up one of the small rocks)
Taken.

>take rock
(the bunch of rocks)
(picking up another of the small rocks)
Taken.

You hear a distant train whistle.

>take small rock
(the small rock)
(picking up another of the small rocks)
(putting the page torn out of a children's book into nothing to make room)
Taken.

>i
You are holding three small rocks.

You are wearing your tall rubber boots, your coat and a watch.

The left pocket of your coat is empty, and in the right pocket is a page torn out of a children's book.

A gull swoops down and pecks at the drawer.

>drop rock
(the small rock)
Dropped.

>take rock
What do you want to take: a small rock or the bunch of rocks?

>l
Rocky Beach
A small strip of shoreline, littered with small disclike rocks; sunlight strikes the rippling pond. A wooden drawer is half-buried in the beach. The small structure is visible at the edge of the water to the west.

The shoreline continues to the southwest and to the northeast, and behind you to the south and east is a chain-link fence.

You can see a small rock and a gull here.

>take the small rock
(the small rock)
Taken.

The gull tires of the drawer and flaps up and away.

>take another small rock
(the small rock)
(picking up another of the small rocks)
(putting the small rock into nothing to make room)
Taken.

>take yet another small rock!
You can't see any such thing.

>take a small rock
(the small rock)
(picking up another of the small rocks)
(putting the small rock into nothing to make room)
Taken.

>take a disc
(the small rock)
(picking up another of the small rocks)
You probably have enough. You have better things to do than cart rocks around all day.

>i
You are holding three small rocks.

You are wearing your tall rubber boots, your coat and a watch.

The left pocket of your coat is empty, and in the right pocket are two small rocks and a page torn out of a children's book.

A murmuration of starlings flies by you.

>skip rock
(the small rock)
You must supply a second noun.

A murmuration of starlings flies by you.

>skip
You jump on the spot, fruitlessly.

* * *

>take rock
(the bunch of rocks)
(picking up another of the small rocks)
Taken.

You hear a distant train whistle.

>skip rock
(the small rock)
You skip the small, disclike rock across the smooth service of the water -- 3 hops.

>take rock
(the bunch of rocks)
(picking up another of the small rocks)
Taken.

A gull swoops down and pecks at the drawer.

>w
(first opening the door to the structure)
(first unlocking the door to the structure)
Damn. It's locked.

A skein of geese passes overhead.

>e
You manage to pull yourself up to the top of the fence and drop down on the other side, without causing yourself too much damage.

Outside Waterworks
You are standing on a paved path leading uphill to the south and downhill to the north.

To the east is a broad brick building on which a lighted archway frames a closed door; a water fountain stands to one side in the archway.

To the west you can see what looks like a pond, with a small structure rising from the water to the northwest. A chain-link fence is blocking you from going up to the edge of the pond; the ground dips a little on this side of the fence, exposing a large rusty pipe.

>s
Hill
You are standing on the top of a small hill, overlooking the pond. The hill stretches out, covered in a carpet of brown and yellow leaves. A lone sweetgum tree stands atop the hill, and just under the tree, a bench faces northwest out over the pond. Some twisty, broken stairs lead down to the southwest, to the east is a small brick building, to the north is the path back to the Waterworks, and to the southeast is a dense grove of pine trees.

You can see a bench here.

>e
Visitor Center
This one-room brick building is paneled on the inside with thick slabs of wood; sunlight through the single window reflects lustrously off the panels. Against one of the walls is an old vending machine and a shelf.

>put rock in machine
(the small rock in the vending machine)
It slips smoothly into the machine, and you hear a click.

>open machine
You open the vending machine, revealing a ticket and a newspaper.

>take ticket
[Your score has just gone up by two points.]

>take newspaper
(putting the page torn out of a children's book into nothing to make room)
Taken.

>x window
A large multi-paned window, slightly dusty, but still admitting plenty of sunlight -- outside, you catch a glimpse of a carpet of leaves.

>dust window
You wipe off some of the dust, but the only result is a clearer view of the hill outside.

>out
(that is, west)

Hill
You are standing on the top of a small hill, overlooking the pond. The hill stretches out, covered in a carpet of brown and yellow leaves. A lone sweetgum tree stands atop the hill, and just under the tree, a bench faces northwest out over the pond. Some twisty, broken stairs lead down to the southwest, to the east is a small brick building, to the north is the path back to the Waterworks, and to the southeast is a dense grove of pine trees.

You can see a bench here.

>x ticket
A little torn, but still good -- in fact, it's a monthly pass with a week left on it.

You hear a faint tinkling sound.

>d
Freshwater Crossing
Two slim, papery birch trees flank a set of rusty, vine-covered railroad tracks at the bottom of the hill. A sign reading "FRESHWATER CROSSING" hangs crookedly from one of the trees.

Twisty stairs lead up to the northeast, and to the northwest is a grassy area. To the east and south are dense, gnarled pine trees.

>x watch
Supposedly waterproof up to 300 feet. The time reads nineteen after.

>x schedule
That noun did not make sense in this context.

>i
You are holding a newspaper, a ticket and a small rock.

You are wearing your tall rubber boots, your coat and a watch.

The left pocket of your coat is empty, and in the right pocket is a page torn out of a children's book.

>z
Time passes.

>z
Time passes.

Leaves waft intermittently to the ground.

>z
Time passes.

You hear an approaching train whistle.

>z
Time passes.

>z
Time passes.

A mysterious steam train comes hurtling in your direction!

>z
Time passes.

A skein of geese passes overhead.

A mysterious steam train pulls up and stops in front of you!

>z
Time passes.

>get in train
Steam Train
The train is outfitted on the inside with several seats, each upholstered in a dingy rust-colored corduroy at least twenty years old. At one end of the car is an access panel in dull, dented metal. 

Outside the window you can see Freshwater Crossing.

You can see a conductor here.

[Your score has just gone up by one point.]

>talk to conductor
To start a conversation, try to ASK the conductor ABOUT something or TELL the conductor ABOUT something.

>ask conductor about schedule
There oughtta be a schedule at the visitor center.

>ask conductor about self
"I'm Eric! Pleased to meetcha!" He shakes your hand vigorously.

The train hurtles away, taking you with it!

>ask eric about train
"Now there's something I know about!" The conductor smiles, and gets a glazed look in his eye; in fact, now that he's on his favorite subject, he doesn't seem to be paying attention to anything you're doing. "Now this one we're riding is the PX1105; she has a rolling resistance of about 0.0005, which means she has to be pretty heavy to get enough traction. Almost three tons! Steam-powered, of course; there are those who say it's obsolete, but give me a taper boiler like this one any day."

>open panel
You sneak a glance at the conductor -- he's still wrapped up talking about trains, and doesn't seem to be paying attention to you. Feeling a bit guilty, you open the access panel, revealing a flashlight, a screwdriver and a wrench.

"This track here is narrow gauge; it's just local, so we don't join up with the national system or anything. Oh, and check out this rolling stock!" He kicks the floor of the train with a pleased smile. "Decades old and still solid as a rock. All steel!"

>take all
flashlight: (putting the small rock into nothing to make room)
Taken.
screwdriver: (putting the newspaper into nothing to make room)
Taken.
wrench: (putting the ticket into nothing to make room)
Taken.

"This locomotive is a 2-6-2, you know. Originally designed to work with a tender, but we just refill the boiler every run since we have plenty o' water around here! And we got a mechanical stoker, so I can take a break from that to come out here and talk the ears off of the passengers."

>x eric
An affable young man with reddish hair and a redder droopy mustache; he is wearing pants that are slightly too big for him, suspenders, and a striped cap. He seems completely oblivious to you now that he's talking about trains.

The train starts to slow down.

The conductor seems to remember where he is, with a bit of a start. "Oh, sorry for boring you with all that. Sometimes I forget not everyone finds this stuff so fascinatin'!"

>open panel
The conductor catches what you're doing and stops you. "Hey! That's train property, that is!"

The train comes to a halt.

>i
You are holding a wrench, a screwdriver and a flashlight.

You are wearing your tall rubber boots, your coat and a watch.

The left pocket of your coat is empty, and in the right pocket are a ticket, a newspaper, a small rock and a page torn out of a children's book.

>out
Other Side of the Pond
A foggy clearing in the woods that fades out into a small, dirty beach -- the railroad tracks pass through, entwined in purple viburnum vines, straight lines over the damp ground. 

To the east is the shore of the familiar pond, with a few stone steps leading into the misty water, and in every other direction, dense woods. Water is trickling faintly onto the wet steps from underground.

A train is stopped on the tracks, puffing steam.

A dense patch of mist passes through you.

>get on train
You try to get on the train, but the conductor shakes his head and blocks your way. "Sorry, friend! I'd love to let you on, but you gotta have a ticket."

>take ticket
(putting the wrench into nothing to make room)

>get on train
Steam Train
The train is outfitted on the inside with several seats, each upholstered in a dingy rust-colored corduroy at least twenty years old. At one end of the car is an access panel in dull, dented metal. 

Outside the window you can see a misty clearing.

You can see a conductor here.

The train hurtles away, taking you with it!

>x panel
The handle of the panel is bent and twisted, and there's a substantial dent in the side of the panel.

>open panel
The conductor catches what you're doing and stops you. "Hey! That's train property, that is!"

>z
Time passes.

>z
Time passes.

>z
Time passes.

The train starts to slow down.

>l
Steam Train
The train is outfitted on the inside with several seats, each upholstered in a dingy rust-colored corduroy at least twenty years old. At one end of the car is an access panel in dull, dented metal. 

Outside the windows you can see trees zooming by, with an occasional glimpse of pond between them.

You can see a conductor here.

The train comes to a halt.

>l
Steam Train
The train is outfitted on the inside with several seats, each upholstered in a dingy rust-colored corduroy at least twenty years old. At one end of the car is an access panel in dull, dented metal. 

Outside the window you can see Freshwater Crossing.

You can see a conductor here.

>out
Freshwater Crossing
Two slim, papery birch trees flank a set of rusty, vine-covered railroad tracks at the bottom of the hill. A sign reading "FRESHWATER CROSSING" hangs crookedly from one of the trees.

Twisty stairs lead up to the northeast, and to the northwest is a grassy area. To the east and south are dense, gnarled pine trees.

A train is stopped on the tracks, puffing steam.

>ne
Hill
You are standing on the top of a small hill, overlooking the pond. The hill stretches out, covered in a carpet of brown and yellow leaves. A lone sweetgum tree stands atop the hill, and just under the tree, a bench faces northwest out over the pond. Some twisty, broken stairs lead down to the southwest, to the east is a small brick building, to the north is the path back to the Waterworks, and to the southeast is a dense grove of pine trees.

You can see a bench here.

A series of indistinct chimes sound.

Leaves waft intermittently to the ground.

>s
In that direction the hill drops precipitously down -- too precipitously to risk -- directly into the pond, a tumble of rocks and mud and tree roots and strange little marsh plants.

You hear a faint tinkling sound.

>nw
In that direction the hill drops precipitously down -- too precipitously to risk -- directly into the pond, a tumble of rocks and mud and tree roots and strange little marsh plants.

A series of indistinct chimes sound.

>ne
In that direction the hill drops precipitously down -- too precipitously to risk -- directly into the pond, a tumble of rocks and mud and tree roots and strange little marsh plants.

A single "tink!" breaks the silence.

>s
In that direction the hill drops precipitously down -- too precipitously to risk -- directly into the pond, a tumble of rocks and mud and tree roots and strange little marsh plants.

>ne
In that direction the hill drops precipitously down -- too precipitously to risk -- directly into the pond, a tumble of rocks and mud and tree roots and strange little marsh plants.

A series of indistinct chimes sound.

A murmuration of starlings flies by you.

>e
Visitor Center
This one-room brick building is paneled on the inside with thick slabs of wood; sunlight through the single window reflects lustrously off the panels. Against one of the walls is an old vending machine and a shelf.

>d
That way is only a wall.

>w
Hill
You are standing on the top of a small hill, overlooking the pond. The hill stretches out, covered in a carpet of brown and yellow leaves. A lone sweetgum tree stands atop the hill, and just under the tree, a bench faces northwest out over the pond. Some twisty, broken stairs lead down to the southwest, to the east is a small brick building, to the north is the path back to the Waterworks, and to the southeast is a dense grove of pine trees.

You can see a bench here.

A single "tink!" breaks the silence.

A murmuration of starlings flies by you.

>s
In that direction the hill drops precipitously down -- too precipitously to risk -- directly into the pond, a tumble of rocks and mud and tree roots and strange little marsh plants.

A series of indistinct chimes sound.

>n
Outside Waterworks
You are standing on a paved path leading uphill to the south and downhill to the north.

To the east is a broad brick building on which a lighted archway frames a closed door; a water fountain stands to one side in the archway.

To the west you can see what looks like a pond, with a small structure rising from the water to the northwest. A chain-link fence is blocking you from going up to the edge of the pond; the ground dips a little on this side of the fence, exposing a large rusty pipe.

>w
You manage to pull yourself up to the top of the fence and drop down on the other side, without causing yourself too much damage.

Muddy Beach
The pond laps gently up to the pile of brush and sticks accumulated here on the muddy shore.  Rising out of the pond to the north, you can see some kind of structure -- it looks like a small boat-house or spring-house.

Behind you to the east you can climb the fence back to where you came from, and to the northeast the shoreline continues.

You can see a beer bottle (empty) here.

Leaves waft intermittently to the ground.

>open structure
From here, you'd have to swim to the structure, but you could probably get close enough to wade from up the shore to the northeast.

>e
You manage to pull yourself up to the top of the fence and drop down on the other side, without causing yourself too much damage.

Outside Waterworks
You are standing on a paved path leading uphill to the south and downhill to the north.

To the east is a broad brick building on which a lighted archway frames a closed door; a water fountain stands to one side in the archway.

To the west you can see what looks like a pond, with a small structure rising from the water to the northwest. A chain-link fence is blocking you from going up to the edge of the pond; the ground dips a little on this side of the fence, exposing a large rusty pipe.

Leaves waft intermittently to the ground.

>open structure
You'd have to get up to the edge of the pond first.

You hear a distant train whistle.

>w
You manage to pull yourself up to the top of the fence and drop down on the other side, without causing yourself too much damage.

Muddy Beach
The pond laps gently up to the pile of brush and sticks accumulated here on the muddy shore.  Rising out of the pond to the north, you can see some kind of structure -- it looks like a small boat-house or spring-house.

Behind you to the east you can climb the fence back to where you came from, and to the northeast the shoreline continues.

You can see a beer bottle (empty) here.

>ne
Rocky Beach
A small strip of shoreline, littered with small disclike rocks; sunlight strikes the rippling pond. A wooden drawer is half-buried in the beach. The small structure is visible at the edge of the water to the west.

The shoreline continues to the southwest and to the northeast, and behind you to the south and east is a chain-link fence.

You can see a gull here.

* * *

>l
Outside Waterworks
You are standing on a paved path leading uphill to the south and downhill to the north.

To the east is a broad brick building on which a lighted archway frames a closed door; a water fountain stands to one side in the archway. 

To the west you can see what looks like a pond, with a small structure rising from the water to the northwest, although a chain-link fence is blocking you from going right up to the pond. 

The ground dips a little on this side of the fence, exposing a large rusty pipe.

>help
Wetlands is an interactive quagmire, interactive fiction, or text adventure game. 

If you're new to the genre: Emily Short has written a great introduction to playing IF, available at http://inform-fiction.org/I7Downloads/Examples/dm/IntroductionToIF.pdf. 

More specifically: try simple commands like GO NORTH, EXAMINE RIGHT POCKET, ASK SOMEONE ABOUT SOMETHING, INVENTORY, SLEEP, WAIT X MINUTES, PUSH SOMETHING, CLIMB SOMETHING, TURN SOMETHING ON, JUMP, SCORE, UNDO and more... 

There are not actually any time limits in this game. Nothing important will pass you by irrevocably, and it shouldn't be possible to get yourself really stuck (unless you do something obviously dumb like throw out stuff you've found). There are fatal mistakes, but it should be clear when you're about to make them and you can always UNDO if necessary. Or SAVE your game to a file to return to your current situation later. 

Places you've been, things you've seen, and people  you've talked to may change somewhat as your actions in-game affect them and their situations, so you should occasionally wander back to places you've already been, and places that might have seemed like dead ends may open up as you change the state of the world. 

If you're stuck, try opening things, examining things, going in all the directions you can, thinking of unique ways objects can be used, revisiting old locations to see if your actions have changed them... and if all else fails, email the author for hints at clara.raubertas@gmail.com. 

Type CREDITS for game credits.

>score
Things seem to be still on dry land right now!

Nothing very interesting has happened yet -- your score is 0 out of 100.

>l
Outside Waterworks
You are standing on a paved path leading uphill to the south and downhill to the north.

To the east is a broad brick building on which a lighted archway frames a closed door; a water fountain stands to one side in the archway. 

To the west you can see what looks like a pond, with a small structure rising from the water to the northwest, although a chain-link fence is blocking you from going right up to the pond. 

The ground dips a little on this side of the fence, exposing a large rusty pipe.

>e
(first opening the door to the Waterworks)
Inside Waterworks
A spacious interior, with bare brick walls supported by metal girders. To the west is the door back outside, and an unsteady-looking spiral staircase in a corner leads down.

A tall cylinder full of bubbling water stands in a corner.

A woman is sitting at a simple metal desk, carefully sketching something in a notebook. A nameplate on the desk reads "Secretary of Water, Pondside Waterworks".

The woman looks up and smiles at you. "Can I help you?"

The Secretary of Water steals a glance at the page you are holding, then turns back to her notebook, blushing.

>d
"Wait!" says the Secretary of Water. "You're not allowed down there."

>d
You ignore the secretary's warning, and clatter down the twisting staircase. You start to slip, but catch yourself just in time.

Pump Room
The basement of the Waterworks, concrete on every side, windowless, and waterstained; almost the entire room is taken up by a large device.

The spiral staircase leads back up to the main building.

The Secretary of Water leans down over the top of the staircase and looks at you.

The Secretary of Water peers at what you are doing. "Could you please leave that thing to the technicians?"

[Your score has just gone up by five points.]

>x device
A large, complex pump of some kind -- covered in gadgets and gizmos and levers and wires and hoses.

The complicated pump is currently switched off.

The Secretary of Water leans down over the top of the staircase and looks at you.

She drums her fingers on the railing. "I'm really not supposed to let you mess with the pump!"

>turn on pump
You consider yourself pretty good with technology, but you're not really sure which of the levers or gizmos or gadgets you should manipulate.

>x gadgets
There is a single gadget on the pump: some kind of security gadget, with a keyhole in it, and featuring three small warning lights that are blinking ominously.

The Secretary of Water leans down over the top of the staircase and looks at you.

"Um, could you...?" says the Secretary of Water anxiously.

>u
You make your way up the treacherous stairs.

The Secretary of Water unclenches her hands and returns to her desk. "Thank you!," she says.

Inside Waterworks
A spacious interior, with bare brick walls supported by metal girders. To the west is the door back outside, and an unsteady-looking spiral staircase in a corner leads down.

A tall cylinder full of bubbling water stands in a corner.

The Secretary of Water is sitting at a simple metal desk, carefully sketching something in a notebook. A nameplate on the desk reads "Secretary of Water, Pondside Waterworks".

>w
Outside Waterworks
You are standing on a paved path leading uphill to the south and downhill to the north.

To the east is a broad brick building on which a lighted archway frames an open door; a water fountain stands to one side in the archway. 

To the west you can see what looks like a pond, with a small structure rising from the water to the northwest, although a chain-link fence is blocking you from going right up to the pond. 

The ground dips a little on this side of the fence, exposing a large rusty pipe.

>w
The chain-link fence blocks your way.

A skein of geese passes overhead.

>climb fence
You manage to pull yourself up to the top of the fence and drop down on the other side, without causing yourself too much damage.

Muddy Beach
The pond laps gently up to the pile of brush and sticks accumulated here on the muddy shore. You can see some kind of structure rising out of the pond to the north -- it looks like a small boat-house or spring-house.

Behind you to the east you can climb the fence back to where you came from, and to the northeast the shoreline continues.

You can see a beer bottle (empty) here.

[Your score has just gone up by five points.]

>take bottle
Taken.

>ne
Rocky Beach
A small strip of shoreline, littered with small disclike rocks; sunlight strikes the rippling pond. You can see the structure to the west more clearly now -- it looks like a small boat-house or spring-house -- and it's probably close enough to wade. 

A wooden drawer is half-buried in the beach.

The shoreline continues to the southwest and to the northeast, and behind you to the south and east is a chain-link fence.

>take rock
(picking up one of the small rocks)
Taken.

A gull swoops down and pecks at the drawer.

A murmuration of starlings flies by you.

>n
You peer into the pond and think about it, but something about the murky depths suggests you're better off on land.

>ne
Sandy Beach
The rocks get sparser until here there is only sand, fading under the water into the pond. 

The shoreline continues to the southwest and northeast, and the fence is to the south and east.

>dig
What do you want to dig in?

>sand
You try digging in the sand, but without having a better idea of where to dig, you aren't that likely to find anything.

>dig in sand
You try digging in the sand, but without having a better idea of where to dig, you aren't that likely to find anything.

>x sand
Fine white grains.

>e
You manage to pull yourself up to the top of the fence and drop down on the other side, without causing yourself too much damage.

Outside Waterworks
You are standing on a paved path leading uphill to the south and downhill to the north.

To the east is a broad brick building on which a lighted archway frames an open door; a water fountain stands to one side in the archway. 

To the west you can see what looks like a pond, with a small structure rising from the water to the northwest, although a chain-link fence is blocking you from going right up to the pond. 

The ground dips a little on this side of the fence, exposing a large rusty pipe.

Leaves waft intermittently to the ground.

>s
Hill
You are standing on the top of a small hill, overlooking the pond. The hill stretches out, covered in a carpet of brown and yellow leaves. A lone sweetgum tree stands atop the hill, and just under the tree, a bench faces northwest out over the pond.

Some twisty, broken stairs lead down to the southwest; to the east is a small brick building; to the north is the path back to the Waterworks; and to the south is a dense grove of pine trees.

You can see a bench here.

You hear a faint tinkling sound.

>climb tree
You try to grab the bottom branch, but you're just a foot or so short of being able to reach it.

A single "tink!" breaks the silence.

>jump
You leap up from the ground and try to grab the bottom branch of the tree, but your fingers just brush it and you can't get a grip.

You hear a distant train whistle.

Leaves waft intermittently to the ground.

>stand on bench
You get onto the bench.

>climb tree
From your position standing on the bench, you are just able to reach the bottom branch, and scramble up.

In The Sweetgum Tree
You are hanging on to the lowest branches of the crimson and ochre tree, far above the blue curve of the pond.

You can see some metal wind chimes here.

>take chimes
(the metal wind chimes)
Taken.

>d
You clamber down from the tree.

Hill
You are standing on the top of a small hill, overlooking the pond. The hill stretches out, covered in a carpet of brown and yellow leaves. A lone sweetgum tree stands atop the hill, and just under the tree, a bench faces northwest out over the pond.

Some twisty, broken stairs lead down to the southwest; to the east is a small brick building; to the north is the path back to the Waterworks; and to the south is a dense grove of pine trees.

You can see a bench here.

>e
Visitor Center
This one-room brick building is paneled on the inside with thick slabs of wood; sunlight through the single window reflects lustrously off the panels. Against one of the walls is an old vending machine and a shelf.

On the shelf are a pamphlet and a train schedule.

>put rock in machine
It slips smoothly into the machine, and you hear a click.

>open machine
You open the vending machine, revealing a ticket and a newspaper.

>take all
ticket: Taken.
newspaper: (putting the page torn out of a children's book into nothing to make room)
Taken.
pamphlet: (putting the beer bottle into nothing to make room)
Taken.
train schedule: (putting the metal wind chimes into nothing to make room)
Taken.

[Your score has just gone up by five points.]

>w
Hill
You are standing on the top of a small hill, overlooking the pond. The hill stretches out, covered in a carpet of brown and yellow leaves. A lone sweetgum tree stands atop the hill, and just under the tree, a bench faces northwest out over the pond.

Some twisty, broken stairs lead down to the southwest; to the east is a small brick building; to the north is the path back to the Waterworks; and to the south is a dense grove of pine trees.

You can see a bench here.

>s
Pine Forest
A dense grove of twisty tall pine trees, pine sap oozing out in clumps from between cracks in their rough bark. The ground is covered in a carpet of soft pine needles, dotted with pinecones.

The forest opens up to the north, back to the hill, and slopes down to the west, where you can see railroad tracks.

>take sap with bottle
You scrape a clump of sticky sap into the bottle.

Leaves waft intermittently to the ground.

>w
Freshwater Crossing
Two slim, papery birch trees flank a set of rusty, vine-covered railroad tracks at the bottom of the hill. A sign reading "FRESHWATER CROSSING" hangs crookedly from one of the trees.

Twisty stairs lead up to the northeast, and to the southwest is a grassy area. To the east are dense, gnarled pine trees.

>wait for train
You stand around, keeping an eye out for the train.

You hear an approaching train whistle.

A steam train comes barreling down the tracks in your direction.

A train pulls up and stops in front of you.

Leaves waft intermittently to the ground.

>get on train
Steam Train
The train is outfitted on the inside with several seats, each upholstered in a dingy rust-colored corduroy at least twenty years old. At one end of the car is an access panel in dull, dented metal. 

Outside the window you can see Freshwater Crossing.

You can see a conductor here.

The conductor checks your ticket, and smiles at you. "Thanks, friend!" he says.

[Your score has just gone up by two points.]

>ask him about trains
"Trains! Now there's something I know about!" The conductor smiles, and gets a glazed look in his eye; in fact, now that he's on his favorite subject, he doesn't seem to be paying attention to anything you're doing.

"Now this one we're riding is the PX1105; she has a rolling resistance of about 0.0005, which means she has to be pretty heavy to get enough traction. Almost three tons! Steam-powered, of course; there are those who say it's obsolete, but give me a taper boiler like this one any day."

>open panel
You sneak a glance at the conductor -- he's still wrapped up talking about trains, and doesn't seem to be paying attention to you. Feeling a bit guilty, you open the access panel, revealing a flashlight, a screwdriver and a wrench.

The train rolls away, taking you with it.

"This track here is narrow gauge; it's just Pondside local, so we don't join up with the national system or anything. Oh, and check out this rolling stock!" He kicks the floor of the train with a pleased smile. "Decades old and still solid as a rock. All steel!"

>take all
flashlight: (putting the train schedule into nothing to make room)
Taken.
screwdriver: (putting the pamphlet into nothing to make room)
Taken.
wrench: (putting the ticket into nothing to make room)
Taken.

"This locomotive is a 2-6-2, you know. Originally designed to work with a tender, but we just refill the boiler every run since we have plenty of water around here! And we got a mechanical stoker, so I can take a break from that to come out here and talk the ears off of the passengers."

[Your score has just gone up by six points.]

>i
You are holding a wrench, a screwdriver, a flashlight and a newspaper.

You are wearing your tall rubber boots, your coat and a watch.

The left pocket of your coat is empty, and in the right pocket are a ticket, a pamphlet, a train schedule, some metal wind chimes, a beer bottle (containing a clump of sap) and a page torn out of a children's book.

The conductor seems to remember where he is, with a bit of a start. "Oh, sorry for boring you with all that. Sometimes I forget not everyone finds this stuff so fascinating!"

>put all in left pocket
wrench: Done.
screwdriver: Done.
flashlight: Done.
newspaper: Done.

>x watch
Supposedly waterproof up to 300 feet. The time reads fifty-four after.

The train starts to slow down.

>x me
You've always considered yourself pretty average in the physical department  -- average height, average build, average looks. Maybe a little more athletic than the average person, or with a slightly better sense of direction.

You are wearing your tall rubber boots, your coat and a watch.

The train comes to a halt.

>get out
Other Side of the Pond
A foggy clearing in the woods that fades out into a small, dirty beach -- the railroad tracks pass through, entwined in purple viburnum vines, straight lines over the damp ground. 

To the east is the shore of the familiar pond, with a few stone steps leading into the misty water, and in every other direction, you can enter the dense woods. Water is trickling faintly onto the wet steps from underground.

A train is stopped on the tracks, puffing steam.

[Your score has just gone up by five points.]

>n
Woods
You are surrounded by colorful sweetgum and birch trees, and small rocks and boulders dot the ground underfoot, breaking up the monotony of the damp mat of red and brown leaves.

The trees cluster around you into a dense mesh. You could probably push your way through them in any direction, but they're so uniform that you can't visually distinguish which way leads anywhere except to more woods.

You can see a dog here.

The dog chases its own tail.

From the east, you can feel a misty chill.

>follow dog
The dog is right here.

To the east you think you can hear the faint lapping of the pond.

>l
Woods
You are surrounded by colorful sweetgum and birch trees, and small rocks and boulders dot the ground underfoot, breaking up the monotony of the damp mat of red and brown leaves.

The trees cluster around you into a dense mesh. You could probably push your way through them in any direction, but they're so uniform that you can't visually distinguish which way leads anywhere except to more woods.

You can see a dog here.

The dog wags its tail.

From the east, you can feel a misty chill.

The dog looks up at you expectantly.

>follow dog
The dog is right here.

The dog trots away to the northwest.

>nw
Small Clearing
You are in a small opening in the otherwise almost impassably dense forest; someone appears to have chopped down a few trees to create some space directly around a particular large boulder -- the space is partially filled with a small cinderblock hut. 

The opening gets larger to the southwest, and in every other direction, you see only the dense woods.

You can see a dog here.

The dog wags its tail.

>x splash
It's quite tastefully and realistically done, at least as far as the medium of spray paint allows; the bright blue and white colors accurately portray a splash of fresh water.

Now that you're looking closely, you can see that some of the paint covers a small metal plate that is screwed in to the boulder.

The dog trots away to the southeast.

>unscrew plate
What do you want to unscrew the metal plate with?

>screwdriver
(first taking the screwdriver)
You unscrew the metal plate.

You open the metal plate, revealing a keypad.

>x keypad
Ten metal buttons -- the numbers 0-9 -- smoothed by years of pressing.